1111111111111111111
1111111111111111111
110P1100CCC00000111
1100110011111110011
1100110011111110011
1100000011110000111
111C00001110C111111
1111110011100111111
1111110C11100000E11
1111111111111111111
1111111111111111111
