1111C00
001EP00
0001R00
00011E0
