1111111
1PCE001
1100011
1111111
