111111111
1000C00P1
1E00C0001
111111111
