1111111111
100001E111
100000C001
100000P001
1111111111
