1111111111
100001E111
10000111C1
100000P001
1111111111
