1111111111
100001E111
1000011CC1
100000P001
1111111111
